NO ./assets/lanterns.png
SO ./assets/wall.png
WE ./assets/library.png
EA ./assets/pictures.png

F 41,44,54
C 41,48,68

11111111111111111111111111111111111111
1S000000000000000000000000000000000001
10101001110010001011111000100001110001
10101000100010001010000001100010001001
10101000100010001010000010100000001001
10111000100010001011110010100000001001
10101000100010001010000111100000110001
10101000100001010010000000100001000001
10101001110000100011111000100011111001
10000000000000000000000000000000000001
11111111111111111111111111111111111111
