NO ./assets/1.png
SO ./assets/1.png
WE ./assets/1.png
EA ./assets/1.png

F 184,113,50
C 51,198,227



11111111111111111111111111111
10000100101101000000000000001
1000W100100100000001010000001
11111111111111111111111111111
11111111111111111111111111111
