NO ./assets/lanterns.png
SO ./assets/wall.png
WE ./assets/library.png
EA ./assets/pictures.png

F 41,44,54
C 41,48,68



11111111111111111111111111111
10000100101101000000000000001
1000W100100100000001010000001
11111111111111111111111111111
11111111111111111111111111111
