NO ./assets/lanterns.png
SO ./assets/wall.png
WE ./assets/library.png
EA ./assets/pictures.png

F 41,44,54
C 41,48,68

1111111111111111111111111111111111111111111111111111111111111111
1000000000000000000000000000000000000000000000000000000000000001
1111111111111111111111111111111111111111111111111111111111111001
1111111111111111111111111111111111111111111111111111111111111001
1000000000000000000000000000000000000000000000000000000000000001
1001111111111111111111111111111111111111111111111111111111111111
1001111111111111111111111111111111111111111111111111111111111111
1000000000000000000000000000000000000000000000000000000000000001
1111111111111111111111111111111111111111111111111111111111111001
1111111111111111111111111111111111111111111111111111111111111001
1000000000000000000000000000000000000000000000000000000000000001
1001111111111111111111111111111111111111111111111111111111111111
1001111111111111111111111111111111111111111111111111111111111111
1000000000000000000000000000000000000000000000000000000000000001
1111111111111111111111111111111111111111111111111111111111111001
1111111111111111111111111111111111111111111111111111111111111001
1N00000000000000000000000000000000000000000000000000000000000001
1111111111111111111111111111111111111111111111111111111111111111
