NO ./assets/lanterns.png
SO ./assets/wall.png
WE ./assets/library.png
EA ./assets/pictures.png

    C 41,48,68
F       41,44,54


11111111111111111111111111111
100000000011000000000000000W1
10110000111000000000000000111
1001000000000000000000000001
111111111011000011100000001
100000000011000001110111111111111
11110111111111111000000010001
1111011111111111101010010001
11000000110101111100000010001111
10000000000000101100000010001
10000000000000111010100100001
11111111111111111111111111111
11110111 1110101 101111010001
11111111 1111111 111111111111