C 41,48,68


F 41,44,54
NO ./assets/lanterns.png
SO ./assets/wall.png
WE ./assets/library.png
EA ./assets/pictures.png



  111111111111111111
  1 1100000000000001
 1010011100000011111
 10001   11000001
 10000111000000111111111111111
 100000N0000000000000000000001
 11111111111111111110000000001
                    1000000001
                1   1000000001
                1   1111111111