NO ./assets/lanterns.png
SO ./assets/wall.png
WE ./assets/library.png
EA ./assets/pictures.png

F 41,44,54
C 41,48,68


1111
1001
1S01
1111