NO ./assets/lanterns.png
SO ./assets/wall.png
WE ./assets/library.png
EA ./assets/pictures.png

F 41,44,54
C 41,48,68


11111111
100110N1
10011001
10000001
11100111
10000001
10011001
11111111