F  41,44,54

SO     ./assets/wall.png





WE ./assets/library.png


EA ./assets/pictures.png









C41      ,00000254 ,68



NO ./assets/lanterns.png

11111111111111 
10000W00000001 
10000000000001 
11111111111111