NO ./assets/lanterns.png
SO ./assets/wall.png
WE ./assets/library.png
EA ./assets/pictures.png

C 41,48,68
F 41,44,54

11111111
1E001001
10001001
10000001   111
11100111   101
10000001   111
10011001
11111111



