NO ./assets/lanterns.png
SO ./assets/wall.png
WE ./assets/library.png
EA ./assets/pictures.png

C 41,48,68
F 41,44,54

11111111  111
1E000001  1 1
10000001  1 1
11111111  101
11100111  111
10000001  
10011001  
11111111  