NO ./textures/1.png
SO ./textures/2.png
WE ./textures/3.png
EA ./textures/4.png

F 220,100,0
C 225,30,0

11111111
100110S1
10011001
10000001
11100111
10000001
10011001
11111111