NO ./assets/lanterns.png
SO ./assets/wall.png
WE ./assets/library.png
EA ./assets/pictures.png



F  41,44,54

C 41,     48,68


11111111111111111111111111111
10000000000000000000000000001
10000N00000000000000000000001
11111111111111111111111111111
