NO ./assets/lanterns.png
SO ./assets/wall.png
WE ./assets/library.png
EA ./assets/pictures.png
NO ./assets/lanterns.png
SO ./assets/wall.png


F 184,113,39
C 51,198,227

11111 
10N01
10001
10001
11111